10-Yard Fight	NES
1942	NES
1943: The Battle of Midway	NES
The 3-D Battles of WorldRunner	NES
720°	NES
8 Eyes	NES
Abadox	NES
The Addams Family	NES
The Addams Family: Pugsley's Scavenger Hunt	NES
Advanced Dungeons & Dragons: DragonStrike	NES
Advanced Dungeons & Dragons: Heroes of the Lance	NES
Advanced Dungeons & Dragons: Hillsfar	NES
Advanced Dungeons & Dragons: Pool of Radiance	NES
Adventure Island	NES
"Adventure Island II (NA)
The Adventure Island Part II (EU/AUS)"	NES
Adventure Island 3	NES
Adventures in the Magic Kingdom	NES
The Adventures of Bayou Billy	NES
Adventures of Dino Riki	NES
The Adventures of Gilligan's Island	NES
Adventures of Lolo	NES
Adventures of Lolo 2	NES
Adventures of Lolo 3	NES
The Adventures of Rad Gravity	NES
The Adventures of Rocky and Bullwinkle and Friends	NES
Adventures of Tom Sawyer	NES
Air Fortress	NES
Airwolf	NES
"Al Unser Jr.'s Turbo Racing (NA)
Turbo Racing (EU)"	NES
Alfred Chicken	NES
Alien3	NES
All-Pro Basketball	NES
Alpha Mission	NES
Amagon	NES
American Gladiators	NES
Anticipation	NES
Arch Rivals	NES
Archon	NES
Arkanoid	NES
Arkista's Ring	NES
Asterix	NES
Astyanax	NES
Athena	NES
Athletic World	NES
Attack of the Killer Tomatoes	NES
Aussie Rules Footy	NES
Back to the Future	NES
Back to the Future Part II & III	NES
"Bad Dudes (NA)
Bad Dudes vs. DragonNinja (EU)"	NES
Bad News Baseball	NES
Bad Street Brawler	NES
Balloon Fight	NES
Banana Prince	NES
Bandai Golf: Challenge Pebble Beach	NES
Bandit Kings of Ancient China	NES
Barbie	NES
The Bard's Tale	NES
Barker Bill's Trick Shooting	NES
Base Wars	NES
Baseball	NES
Baseball Simulator 1.000	NES
Baseball Stars	NES
Baseball Stars 2	NES
Bases Loaded	NES
Bases Loaded II: Second Season	NES
Bases Loaded 3	NES
Bases Loaded 4	NES
Batman	NES
Batman Returns	NES
Batman: Return of the Joker	NES
Battle Chess	NES
The Battle of Olympus	NES
Battle Tank	NES
Battleship	NES
Battletoads	NES
Battletoads & Double Dragon	NES
Beetlejuice	NES
Best of the Best: Championship Karate	NES
Bigfoot	NES
Bill & Ted's Excellent Video Game Adventure	NES
Bill Elliott's NASCAR Challenge	NES
Bionic Commando	NES
The Black Bass	NES
Blades of Steel	NES
Blaster Master	NES
The Blue Marlin	NES
The Blues Brothers	NES
Bo Jackson Baseball	NES
Bomberman	NES
"Bomberman II (NA)
Dynablaster (EU)"	NES
Bonk's Adventure	NES
Boulder Dash	NES
A Boy and His Blob: Trouble on Blobolonia	NES
Bram Stoker's Dracula	NES
Break Time: The National Pool Tour	NES
BreakThru	NES
Bubble Bobble	NES
Bubble Bobble Part 2	NES
Bucky O'Hare	NES
"The Bugs Bunny Birthday Blowout (NA)
The Bugs Bunny Blowout (EU)"	NES
The Bugs Bunny Crazy Castle	NES
Bump 'n' Jump	NES
Burai Fighter	NES
BurgerTime	NES
Cabal	NES
Caesars Palace	NES
California Games	NES
Capcom's Gold Medal Challenge '92	NES
Captain America and The Avengers	NES
Captain Planet and the Planeteers	NES
Captain Skyhawk	NES
Casino Kid	NES
Casino Kid 2	NES
Castelian	NES
Castle of Dragon	NES
Castlequest	NES
Castlevania	NES
Castlevania II: Simon's Quest	NES
Castlevania III: Dracula's Curse	NES
Caveman Games	NES
Championship Bowling	NES
Championship Pool	NES
Championship Rally	NES
Chessmaster	NES
Chip 'n Dale: Rescue Rangers	NES
Chip 'n Dale: Rescue Rangers 2	NES
Chubby Cherub	NES
Circus Caper	NES
City Connection	NES
Clash at Demonhead	NES
Classic Concentration	NES
Cliffhanger	NES
Clu Clu Land	NES
Cobra Command	NES
Cobra Triangle	NES
Code Name: Viper	NES
Color a Dinosaur	NES
Commando	NES
Conan: The Mysteries of Time	NES
Conflict	NES
Conquest of the Crystal Palace	NES
"Contra (NA)
Probotector (EU)"	NES
Contra Force	NES
Cool World	NES
Cowboy Kid	NES
Crackout	NES
Crash 'n the Boys: Street Challenge	NES
Crystalis	NES
Cyberball	NES
Cybernoid: The Fighting Machine	NES
Dance Aerobics	NES
Danny Sullivan's Indy Heat	NES
Darkman	NES
Dash Galaxy in the Alien Asylum	NES
Day Dreamin' Davey	NES
Days of Thunder	NES
Deadly Towers	NES
Defender II	NES
Defender of the Crown	NES
Defenders of Dynatron City	NES
Deja Vu	NES
Demon Sword	NES
Desert Commander	NES
Destination Earthstar	NES
Destiny of an Emperor	NES
Devil World	NES
Dick Tracy	NES
Die Hard	NES
Dig Dug II	NES
Digger T. Rock: Legend of the Lost City	NES
Dirty Harry	NES
Disney's Aladdin	NES
Disney's Beauty and the Beast	NES
Disney's Darkwing Duck	NES
Disney's The Jungle Book	NES
Disney's The Lion King	NES
Disney's The Little Mermaid	NES
Donkey Kong	NES
Donkey Kong 3	NES
Donkey Kong Classics	NES
Donkey Kong Jr.	NES
Donkey Kong Jr. Math	NES
Double Dare	NES
Double Dragon	NES
Double Dragon II: The Revenge	NES
Double Dragon III: The Sacred Stones	NES
Double Dribble	NES
Dr. Chaos	NES
Dr. Jekyll and Mr. Hyde	NES
Dr. Mario	NES
Dragon Fighter	NES
"Dragon Power (NA)
Dragon Ball: Le Secret du Dragon (FRA)"	NES
Dragon Spirit: The New Legend	NES
Dragon Warrior	NES
Dragon Warrior II	NES
Dragon Warrior III	NES
Dragon Warrior IV	NES
Dragon's Lair	NES
Dropzone	NES
Duck Hunt	NES
DuckTales	NES
DuckTales 2	NES
Dungeon Magic: Sword of the Elements	NES
Dusty Diamond's All-Star Softball	NES
Dynowarz: Destruction of Spondylus	NES
Elevator Action	NES
Eliminator Boat Duel	NES
Elite	NES
Excitebike	NES
F-117A Stealth Fighter	NES
F-15 Strike Eagle	NES
Family Feud	NES
Faria: A World of Mystery and Danger	NES
Faxanadu	NES
Felix the Cat	NES
Ferrari Grand Prix Challenge	NES
Fester's Quest	NES
Final Fantasy	NES
"Fire 'n Ice (NA)
Solomon's Key 2 (EU)"	NES
Fisher-Price: Firehouse Rescue	NES
Fisher-Price: I Can Remember	NES
Fisher-Price: Perfect Fit	NES
Fist of the North Star	NES
Flight of the Intruder	NES
The Flintstones: The Rescue of Dino & Hoppy	NES
The Flintstones: Surprise at Dinosaur Peak	NES
Flying Dragon: The Secret Scroll	NES
Flying Warriors	NES
Formula 1 Sensation	NES
Formula One: Built to Win	NES
Frankenstein: The Monster Returns	NES
Freedom Force	NES
Friday the 13th	NES
Fun House	NES
G.I. Joe: A Real American Hero	NES
G.I. Joe: The Atlantis Factor	NES
"Galaga: Demons of Death (NA)
Galaga (EU)"	NES
Galaxy 5000	NES
Gargoyle's Quest II	NES
Gauntlet[a]	NES
Gauntlet II	NES
Gemfire	NES
Genghis Khan	NES
George Foreman's KO Boxing	NES
Ghostbusters	NES
Ghostbusters II	NES
Ghost Lion	NES
Ghosts 'n Goblins	NES
Ghoul School	NES
Goal!	NES
Goal! Two	NES
Godzilla: Monster of Monsters	NES
Godzilla 2: War of the Monsters	NES
Golf	NES
Golf Grand Slam	NES
Golgo 13: Top Secret Episode	NES
The Goonies II	NES
Gotcha! The Sport!	NES
Gradius	NES
The Great Waldo Search	NES
Greg Norman's Golf Power	NES
Gremlins 2: The New Batch	NES
The Guardian Legend	NES
Guerrilla War	NES
Gumshoe	NES
Gun-Nac	NES
Gun.Smoke	NES
Gyromite	NES
Gyruss	NES
Hammerin' Harry	NES
Harlem Globetrotters	NES
Hatris	NES
Heavy Barrel	NES
Heavy Shreddin'	NES
High Speed	NES
Hogan's Alley	NES
Hollywood Squares	NES
Home Alone	NES
Home Alone 2: Lost in New York	NES
Hook	NES
Hoops	NES
Hudson Hawk	NES
The Hunt for Red October	NES
Hydlide	NES
Ice Climber	NES
Ice Hockey	NES
Ikari Warriors	NES
Ikari Warriors II: Victory Road	NES
Ikari Warriors III: The Rescue	NES
Image Fight	NES
The Immortal	NES
The Incredible Crash Dummies	NES
Indiana Jones and the Last Crusade	NES
"Indiana Jones and the Last Crusade (NA)
Indy: Indiana Jones and the Last Crusade (EU)"	NES
Indiana Jones and the Temple of Doom[a]	NES
Infiltrator	NES
International Cricket	NES
Iron Tank: The Invasion of Normandy	NES
Ironsword: Wizards & Warriors II	NES
Isolated Warrior	NES
Ivan 'Ironman' Stewart's Super Off Road	NES
Jack Nicklaus' Greatest 18 Holes of Major Championship Golf	NES
Jackal	NES
Jackie Chan's Action Kung Fu	NES
James Bond Jr.	NES
Jaws	NES
Jeopardy!	NES
Jeopardy! 25th Anniversary Edition	NES
Jeopardy! Junior Edition	NES
The Jetsons: Cogswell's Caper!	NES
Jimmy Connors Tennis	NES
"Joe & Mac (NA)
Joe & Mac: Caveman Ninja (EU)"	NES
John Elway's Quarterback	NES
Jordan vs. Bird: One on One	NES
Journey to Silius	NES
Joust	NES
Jurassic Park	NES
Kabuki Quantum Fighter	NES
Karate Champ	NES
The Karate Kid	NES
Karnov	NES
Kick Master	NES
Kick Off	NES
Kickle Cubicle	NES
Kid Icarus	NES
Kid Klown in Night Mayor World	NES
Kid Kool	NES
Kid Niki: Radical Ninja	NES
King's Knight	NES
Kings of the Beach	NES
King's Quest V: Absence Makes the Heart Go Yonder!	NES
Kirby's Adventure	NES
"Kiwi Kraze (NA)
The NewZealand Story (EU/AUS)"	NES
KlashBall	NES
Knight Rider	NES
Konami Hyper Soccer	NES
The Krion Conquest	NES
Krusty's Fun House	NES
Kung Fu	NES
Kung-Fu Heroes	NES
Laser Invasion	NES
Last Action Hero	NES
The Last Ninja	NES
The Last Starfighter	NES
Lee Trevino's Fighting Golf	NES
Legacy of the Wizard	NES
The Legend of Kage	NES
The Legend of Prince Valiant	NES
The Legend of Zelda	NES
Legendary Wings	NES
Legends of the Diamond	NES
Lemmings	NES
L'Empereur	NES
Les Chevaliers du Zodiaque: La Legende d'or	NES
Lethal Weapon	NES
"Life Force (NA)
Life Force Salamander (EU)"	NES
Little League Baseball: Championship Series	NES
Little Nemo: The Dream Master	NES
Little Ninja Brothers	NES
Little Samson	NES
Lode Runner	NES
The Lone Ranger	NES
Loopz	NES
Low G Man: The Low Gravity Man	NES
Lunar Pool	NES
"M.C. Kids (NA)
McDonaldland (EU)"	NES
M.U.L.E.	NES
M.U.S.C.L.E.	NES
Mach Rider	NES
Mad Max	NES
The Mafat Conspiracy	NES
Magic Darts	NES
Magic Johnson's Fast Break	NES
The Magic of Scheherazade	NES
Magician	NES
MagMax	NES
Major League Baseball	NES
Maniac Mansion	NES
Mappy-Land	NES
Marble Madness	NES
Mario Bros.	NES
Mario Bros. (Classic Series)	NES
Mario Is Missing!	NES
Mario's Time Machine	NES
Mechanized Attack	NES
Mega Man	NES
Mega Man 2	NES
Mega Man 3	NES
Mega Man 4	NES
Mega Man 5	NES
Mega Man 6	NES
Mendel Palace	NES
Metal Gear	NES
Metal Mech	NES
Metal Storm	NES
Metroid	NES
Michael Andretti's World GP	NES
Mickey Mousecapade	NES
Mickey's Adventures in Numberland	NES
Mickey's Safari in Letterland	NES
Might and Magic Book One: The Secret of the Inner Sanctum	NES
Mighty Bomb Jack	NES
Mighty Final Fight	NES
Mike Tyson's Punch-Out!!	NES
Millipede	NES
Milon's Secret Castle	NES
The Miracle Piano Teaching System	NES
Mission: Impossible	NES
Monopoly	NES
Monster in My Pocket	NES
Monster Party	NES
Monster Truck Rally	NES
Motor City Patrol	NES
Mr. Gimmick	NES
Ms. Pac-Man	NES
Muppet Adventure: Chaos at the Carnival	NES
The Mutant Virus: Crisis in a Computer World	NES
Mystery Quest	NES
NARC	NES
NES Open Tournament Golf	NES
NES Play Action Football	NES
New Ghostbusters II	NES
NFL Football	NES
Nigel Mansell's World Championship Racing	NES
A Nightmare on Elm Street	NES
Nightshade	NES
Ninja Crusaders	NES
"Ninja Gaiden (NA)
Shadow Warriors (EU)"	NES
"Ninja Gaiden II: The Dark Sword of Chaos (NA)
Shadow Warriors II: Ninja Gaiden (EU)"	NES
Ninja Gaiden III: The Ancient Ship of Doom	NES
Ninja Kid	NES
Nintendo World Cup	NES
Noah's Ark	NES
Nobunaga's Ambition	NES
Nobunaga's Ambition II	NES
North & South	NES
Operation Wolf	NES
Orb-3D	NES
Othello	NES
Over Horizon	NES
Overlord	NES
P.O.W.: Prisoners of War	NES
Pac-Man	NES
Pac-Man[a]	NES
Palamedes	NES
Panic Restaurant	NES
Paperboy	NES
Paperboy 2	NES
Parasol Stars: Rainbow Islands II	NES
Parodius	NES
Peter Pan and the Pirates	NES
Phantom Fighter	NES
Pictionary	NES
Pinball	NES
Pinball Quest	NES
Pin*Bot	NES
Pipe Dream	NES
Pirates!	NES
Platoon	NES
Popeye	NES
Power Blade	NES
Power Blade 2	NES
Power Punch II	NES
Predator	NES
Prince of Persia	NES
Princess Tomato in the Salad Kingdom	NES
Pro Sport Hockey	NES
Pro Wrestling	NES
Punch-Out!!	NES
The Punisher	NES
Puss 'n Boots: Pero's Great Adventure	NES
Puzznic	NES
Q*bert	NES
Qix	NES
R.B.I. Baseball[a]	NES
R.C. Pro-Am	NES
R.C. Pro-Am II	NES
"Race America (NA)
Corvette ZR-1 Challenge (EU)"	NES
Racket Attack	NES
Rackets & Rivals	NES
Rad Racer	NES
Rad Racer II	NES
Raid on Bungeling Bay	NES
Rainbow Islands	NES
Rainbow Islands: Bubble Bobble 2	NES
Rally Bike	NES
Rambo	NES
Rampage	NES
Rampart	NES
Remote Control	NES
The Ren & Stimpy Show: Buckaroo$!	NES
Renegade	NES
Rescue: The Embassy Mission	NES
Ring King	NES
"River City Ransom (NA)
Street Gangs (EU)"	NES
Road Fighter	NES
RoadBlasters	NES
Robin Hood: Prince of Thieves	NES
RoboCop	NES
RoboCop 2	NES
RoboCop 3	NES
Robowarrior	NES
Rock 'n' Ball	NES
Rocket Ranger	NES
The Rocketeer	NES
Rockin' Kats	NES
Rod Land	NES
Roger Clemens' MVP Baseball	NES
Rollerball	NES
Rollerblade Racer	NES
RollerGames	NES
Romance of the Three Kingdoms	NES
Romance of the Three Kingdoms II	NES
Roundball: 2 on 2 Challenge	NES
Rush'n Attack	NES
Rygar	NES
"S.C.A.T.: Special Cybernetic Attack Team (NA)
Action in New York (EU)"	NES
Section Z	NES
Seicross	NES
Sesame Street: 1-2-3	NES
Sesame Street: A-B-C	NES
Sesame Street: A-B-C/1-2-3	NES
Sesame Street: Big Bird's Hide & Speak	NES
Sesame Street: Countdown	NES
"Shadow of the Ninja (NA)
Blue Shadow (EU)"	NES
Shadowgate	NES
Shatterhand	NES
Shingen the Ruler	NES
Shooting Range	NES
Short Order / Eggsplode!	NES
Side Pocket	NES
Silent Service	NES
Silkworm	NES
Silver Surfer	NES
The Simpsons: Bart vs. the Space Mutants	NES
The Simpsons: Bart vs. the World	NES
The Simpsons: Bartman Meets Radioactive Man	NES
Skate or Die!	NES
Skate or Die 2: The Search for Double Trouble	NES
Ski or Die	NES
Sky Kid	NES
Sky Shark	NES
Slalom	NES
Smash TV	NES
The Smurfs	NES
Snake Rattle 'n' Roll	NES
Snake's Revenge	NES
Snoopy's Silly Sports Spectacular	NES
Snow Brothers	NES
Soccer	NES
Solar Jetman: Hunt for the Golden Warpship	NES
Solomon's Key	NES
Solstice: The Quest for the Staff of Demnos	NES
Space Shuttle Project	NES
Spelunker	NES
Spider-Man: Return of the Sinister Six	NES
Spot: The Video Game	NES
Spy Hunter	NES
Spy vs. Spy	NES
Sqoon	NES
Stack-Up	NES
Stadium Events	NES
Stanley: The Search for Dr. Livingston	NES
Star Force	NES
Star Soldier	NES
Star Trek: 25th Anniversary	NES
Star Trek: The Next Generation	NES
Star Voyager	NES
Star Wars	NES
Star Wars: The Empire Strikes Back	NES
Starship Hector	NES
StarTropics	NES
Stealth ATF	NES
Stinger	NES
Street Cop	NES
Street Fighter 2010: The Final Fight	NES
Strider	NES
"Super C (aka Super Contra) (NA)
Probotector II: Return of The Evil Forces (EU)"	NES
Super Cars	NES
Super Dodge Ball	NES
Super Glove Ball	NES
Super Jeopardy!	NES
Super Mario Bros.	NES
Super Mario Bros./Duck Hunt	NES
Super Mario Bros./Duck Hunt/World Class Track Meet	NES
Super Mario Bros./Tetris/Nintendo World Cup	NES
Super Mario Bros. 2	NES
Super Mario Bros. 3	NES
Super Pitfall	NES
Super Spike V'Ball	NES
Super Spike V'Ball/Nintendo World Cup	NES
Super Spy Hunter	NES
Super Team Games	NES
Super Turrican	NES
Superman	NES
Swamp Thing	NES
Sword Master	NES
Swords and Serpents	NES
Taboo: The Sixth Sense	NES
Tag Team Wrestling	NES
TaleSpin	NES
Target: Renegade	NES
Tecmo Baseball	NES
Tecmo Bowl	NES
Tecmo Cup Soccer Game	NES
Tecmo NBA Basketball	NES
Tecmo Super Bowl	NES
Tecmo World Cup Soccer	NES
Tecmo World Wrestling	NES
"Teenage Mutant Ninja Turtles (NA)
Teenage Mutant Hero Turtles (EU)"	NES
"Teenage Mutant Ninja Turtles II: The Arcade Game (NA)
Teenage Mutant Hero Turtles II: The Arcade Game (EU)"	NES
Teenage Mutant Ninja Turtles III: The Manhattan Project	NES
"Teenage Mutant Ninja Turtles: Tournament Fighters (NA)
Teenage Mutant Hero Turtles: Tournament Fighters (EU)"	NES
Tennis	NES
The Terminator	NES
Terminator 2: Judgment Day	NES
Terra Cresta	NES
Tetris	NES
Tetris 2	NES
The Three Stooges	NES
Thunder & Lightning	NES
Thunderbirds	NES
Thundercade	NES
Tiger-Heli	NES
Time Lord	NES
Times of Lore	NES
Tiny Toon Adventures	NES
Tiny Toon Adventures 2: Trouble in Wackyland	NES
Tiny Toon Adventures Cartoon Workshop	NES
To the Earth	NES
Toki	NES
Tom and Jerry	NES
Tombs & Treasure	NES
Top Gun	NES
Top Gun: The Second Mission	NES
"Top Players' Tennis (NA)
Four Players' Tennis (EU)"	NES
Total Recall	NES
Totally Rad	NES
Touch Down Fever	NES
Town & Country Surf Designs: Wood & Water Rage	NES
Town & Country II: Thrilla's Surfari	NES
Toxic Crusaders	NES
"Track & Field (NA)
Track & Field in Barcelona (EU)"	NES
Track & Field II	NES
Treasure Master	NES
Trog!	NES
Trojan	NES
The Trolls in Crazyland	NES
Twin Cobra	NES
Twin Eagle	NES
Ufouria: The Saga	NES
Ultima III: Exodus	NES
Ultima IV: Quest of the Avatar	NES
Ultima V: Warriors of Destiny	NES
Ultimate Air Combat	NES
Ultimate Basketball	NES
The Uncanny X-Men	NES
Uncharted Waters	NES
Uninvited	NES
The Untouchables	NES
Urban Champion	NES
Vegas Dream	NES
Vice: Project Doom	NES
Videomation	NES
Volleyball	NES
Wacky Races	NES
Wall Street Kid	NES
Wario's Woods	NES
Wayne Gretzky Hockey	NES
Wayne's World	NES
WCW Wrestling	NES
Werewolf: The Last Warrior	NES
Wheel of Fortune	NES
Wheel of Fortune Family Edition	NES
Wheel of Fortune: Featuring Vanna White	NES
Wheel of Fortune Junior Edition	NES
Where in Time Is Carmen Sandiego?	NES
Where's Waldo?	NES
Who Framed Roger Rabbit	NES
Whomp 'Em	NES
Widget	NES
Wild Gunman	NES
Willow	NES
Win, Lose, or Draw	NES
Winter Games	NES
Wizardry: Proving Grounds of the Mad Overlord	NES
Wizardry II: The Knight of Diamonds	NES
Wizards & Warriors	NES
"Wizards & Warriors III: Kuros: Visions of Power (NA)
Wizards & Warriors III (EU)"	NES
Wolverine	NES
World Champ	NES
World Class Track Meet	NES
World Games	NES
Wrath of the Black Manta	NES
Wrecking Crew	NES
Wurm: Journey to the Center of the Earth	NES
WWF King of the Ring	NES
WWF WrestleMania	NES
WWF WrestleMania Challenge	NES
WWF WrestleMania: Steel Cage Challenge	NES
Xenophobe	NES
Xevious	NES
Xexyz	NES
Yo! Noid	NES
"Yoshi (NA)
Mario & Yoshi (EU)"	NES
Yoshi's Cookie	NES
The Young Indiana Jones Chronicles	NES
Zanac	NES
Zelda II: The Adventure of Link	NES
Zen the Intergalactic Ninja	NES
Zoda's Revenge: StarTropics II	NES
Zombie Nation	NES
$1,000,000 Kid: Maboroshi no Teiou Hen	Famicom
89 Denno Kyusei Uranai	Famicom
10-Yard Fight	Famicom
1942	Famicom
1943: The Battle of Valhalla	Famicom
1999: Hore, Mita koto ka! Seikimatsu	Famicom
2010 Street Fighter	Famicom
4 Nin Uchi Mahjong	Famicom
8 Eyes	Famicom
A Ressha de Ikou	Famicom
A Week of Garfield	Famicom
Aa Yakyu Jinsei Itchokusen	Famicom
Abadox	Famicom
Abarenbou Tengu	Famicom
Aces: Iron Eagle III	Famicom
Advanced Dungeons & Dragons: Dragons of Flame	Famicom
Advanced Dungeons & Dragons: Heroes of the Lance	Famicom
Advanced Dungeons & Dragons: Hillsfar	Famicom
Advanced Dungeons & Dragons: Pool of Radiance	Famicom
Adventures of Lolo	Famicom
Adventures of Lolo 2	Famicom
After Burner II	Famicom
Ai Sensei no Oshiete: Watashi no Hoshi	Famicom
Aigiina no Yogen: From the Legend of Balubalouk	Famicom
Air Fortress	Famicom
Airwolf	Famicom
Akagawa Jirou no Yuurei Ressha	Famicom
Akira	Famicom
Akuma no Shoutaijou	Famicom
Akuma-kun: Makai no Wana	Famicom
Akumajou Densetsu	Famicom
Akumajou Dracula	Famicom
Akumajou Special: Boku Dracula Kun	Famicom
Alien Syndrome	Famicom
America Daitoryo Senkyo	Famicom
America Oudan Ultra Quiz: Shijou Saidai no Tatakai	Famicom
American Dream	Famicom
Ankoku Shinwa: Yamato Takeru Densetsu	Famicom
Aoki Ookami to Shiroki Mejika: Genchou Hishi	Famicom
Aoki Ookami to Shiroki Mejika: Genghis Khan	Famicom
Arabian Dream Scheherazade	Famicom
Arctic	Famicom
Argos no Senshi	Famicom
Argus	Famicom
Arkanoid	Famicom
Arkanoid II	Famicom
Armadillo	Famicom
Artelius	Famicom
Asmik-kun Land	Famicom
ASO: Armored Scrum Object	Famicom
Astro Fang: Super Machine	Famicom
Astro Robo Sasa	Famicom
Athena	Famicom
Atlantis no Nazo	Famicom
Attack Animal Gakuen	Famicom
B-Wings	Famicom
Babel no Tou	Famicom
Baken Hisshou Gaku: Gate In	Famicom
Bakusho! Ai no Gekijo	Famicom
Bakushou!! Jinsei Gekijou	Famicom
Bakushou!! Jinsei Gekijou 2	Famicom
Bakushou!! Jinsei Gekijou 3	Famicom
Bakusho! Star Monomane Shitenno	Famicom
Ballblazer	Famicom
Balloon Fight	Famicom
Baltron	Famicom
Banana	Famicom
Bananan Ouji no Daibouken	Famicom
Barcode World	Famicom
Bard's Tale: Tales of the Unknown	Famicom
The Bard's Tale II: The Destiny Knight	Famicom
Baseball	Famicom
Baseball Fighter	Famicom
Baseball Stars: Mezase Sankanou!!	Famicom
Batman	Famicom
Bats & Terry	Famicom
Battle Baseball	Famicom
Battle City	Famicom
Battle Fleet	Famicom
Battle Formula	Famicom
Datach: Battle Rush: Build Up Robot Tournament	Famicom
Battle Stadium: Senbatsu Pro Yakyuu	Famicom
Battle Storm	Famicom
Battletoads	Famicom
Be-Bop High School: Koukousei Gokuraku Densetsu	Famicom
Best Keiba: Derby Stallion	Famicom
Best Play Pro Yakyuu	Famicom
Best Play Pro Yakyuu II	Famicom
Best Play Pro Yakyuu '90	Famicom
Best Play Pro Yakyuu Shin Data	Famicom
Best Play Pro Yakyuu Special	Famicom
Bikkuri Nekketsu Shin Kiroku! Harukanaru Kin Medal	Famicom
Bikkuriman World: Gekitou Sei Senshi	Famicom
Binary Land	Famicom
Bio Miracle Bokutte Upa	Famicom
Bio Senshi Dan: Increaser to no Tatakai	Famicom
Bird Week	Famicom
The Black Bass	Famicom
The Black Bass 2	Famicom
Blodia Land: Puzzle Quest	Famicom
Bloody Warriors: Shan-Go no Gyakushuu	Famicom
Blue Marlin, The	Famicom
Bokosuka Wars	Famicom
Bomber King	Famicom
Bomberman	Famicom
Bomberman II	Famicom
Booby Kids	Famicom
Boulder Dash	Famicom
Bubble Bobble 2	Famicom
Bucky O'Hare	Famicom
Buggy Popper	Famicom
Burai Fighter	Famicom
BurgerTime	Famicom
Business Wars	Famicom
Cadillac	Famicom
Capcom Barcelona '92	Famicom
Captain Ed	Famicom
Captain Saver	Famicom
Captain Silver	Famicom
Captain Tsubasa	Famicom
Captain Tsubasa Vol. II: Super Striker	Famicom
Casino Derby & Super Bingo	Famicom
Castle Excellent	Famicom
Castle Quest	Famicom
Chack'n Pop	Famicom
Challenger	Famicom
Championship Bowling	Famicom
Championship Lode Runner	Famicom
Chaos World	Famicom
Chester Field: Ankoku Shin e no Chosen	Famicom
Chibi Maruko-Chan: Uki Uki Shopping	Famicom
Chiisana Obake: Achhi Sochhi Kocchi	Famicom
Chiki Chiki Machine Mou Race	Famicom
Chip to Dale no Daisakusen	Famicom
Chip to Dale no Daisakusen 2	Famicom
Chitei Senkou Bazolder	Famicom
Chiyonofuji no Oicho	Famicom
Choplifter	Famicom
Chou-Wakusei Senki MetaFight	Famicom
Choujikuu Yousai Macross	Famicom
Chojin Sentai Jetman	Famicom
Choujin Ultra Baseball	Famicom
Choujinrou Senki Warwolf	Famicom
Chuugoku Janshi Story: Tonpuu	Famicom
Chuugoku Senseijutsu	Famicom
Chuuka Taisen	Famicom
Circus Charlie	Famicom
City Adventure Touch: Mystery of Triangle	Famicom
City Connection	Famicom
Clu Clu Land	Famicom
Cobra Command	Famicom
Cocoron	Famicom
Columbus: Ougon no Yoake	Famicom
Conflict	Famicom
Contra	Famicom
Cosmic Epsilon	Famicom
Cosmic Wars	Famicom
Cosmo Genesis	Famicom
Cosmo Police Galivan	Famicom
Crayon Shin-Chan: Ora to Poi Poi	Famicom
Crazy Climber	Famicom
Crisis Force	Famicom
Cross Fire	Famicom
Cycle Race: Road Man	Famicom
Dai-2-Ji Super Robot Taisen	Famicom
Daikaijyu Deburasu	Famicom
Daikoukai Jidai	Famicom
Daiku no Gen-San	Famicom
Daiku no Gen-San 2	Famicom
Dai Meiro - Meikyuu no Tatsujin	Famicom
Daisenryaku	Famicom
Daiva	Famicom
Dark Lord	Famicom
Dash Yarou	Famicom
Datach Crayon Shin-Chan: Ora to Poi Poi	Famicom
Datsugoku	Famicom
De-Block	Famicom
Deep Dungeon III	Famicom
Deep Dungeon IV	Famicom
Deja Vu	Famicom
Dengeki Big Bang!	Famicom
Densetsu no Kishi Elrond	Famicom
Derby Stallion Zengokuban	Famicom
Devilman	Famicom
Devil World	Famicom
Dezaemon	Famicom
Die Hard	Famicom
Dig Dug	Famicom
Dig Dug II	Famicom
Digital Devil Monogatari Megami Tensei	Famicom
Digital Devil Monogatari: Megami Tensei II	Famicom
Doki! Doki! Yuenchi: Crazy Land Daisakusen	Famicom
Dokuganryu Masamune	Famicom
Don Doko Don	Famicom
Don Doko Don 2	Famicom
Donald Duck	Famicom
Donald Land	Famicom
Donkey Kong	Famicom
Donkey Kong 3	Famicom
Donkey Kong Jr. Math	Famicom
Donkey Kong Jr.	Famicom
Door Door	Famicom
Doraemon	Famicom
Doraemon: Giga Zombie no Gyakushu	Famicom
Double Dragon	Famicom
Double Dragon II: The Revenge	Famicom
Double Dragon III: The Rosetta Stone	Famicom
Double Moon Densetsu	Famicom
Dough Boy	Famicom
Downtown Nekketsu Koushinkyoku: Soreyuke Daiundoukai	Famicom
Downtown Nekketsu Monogatari	Famicom
Dr. Mario	Famicom
Dragon Ball 3: Gokuuden	Famicom
Dragon Ball Z	Famicom
Dragon Ball Z Side Story: Plan to Eradicate the Saiyans	Famicom
Dragon Ball Z II: Gekishin Freeza	Famicom
Dragon Ball Z III: Ressen Jinzou Ningen	Famicom
Datach: Dragon Ball Z: Gekitou Tenkaichi Budokai	Famicom
Dragon Ball: Daimaou Fukkatsu	Famicom
Dragon Ball: Shenron no Nazo	Famicom
Dragon Buster	Famicom
Dragon Buster II	Famicom
Dragon Fighter	Famicom
Dragon Ninja	Famicom
Dragon Quest	Famicom
Dragon Quest II: Gods of the Evil Spirits	Famicom
Dragon Quest III: And thus into Legend...	Famicom
Dragon Quest IV: The Guided Ones	Famicom
Dragon Scroll	Famicom
Dragon Slayer IV: Drasle Family	Famicom
Dragon Slayer Jr.: Romancia	Famicom
Dragon Spirit: Aratanaru Densetsu	Famicom
Dragon Unit	Famicom
Dragon Wars	Famicom
Dragon's Lair	Famicom
Dream Master	Famicom
Duck Hunt	Famicom
DuckTales 2	Famicom
Dungeon Kid	Famicom
Dungeon & Magic: Sword of Element	Famicom
Dynamite Batman	Famicom
Dynamite Bowl	Famicom
Eggerland: Meikyu no Fukkatsu	Famicom
Egypt	Famicom
Elevator Action	Famicom
Elnark no Zaihou	Famicom
Elysion	Famicom
Emoyan no 10-bai Pro Yakyuu	Famicom
Erika to Satoru no Yume Boken	Famicom
Esper Boukentai	Famicom
Esper Dream 2	Famicom
Excitebike	Famicom
Exciting Boxing	Famicom
Exciting Rally	Famicom
Exed Exes	Famicom
Exerion	Famicom
F1 Circus	Famicom
F-1 Sensation	Famicom
F-1 Race	Famicom
Famicom Igo Nyuumon	Famicom
Famicom Jump: Hero Retsuden	Famicom
Famicom Jump II: The Strongest Seven	Famicom
Famicom Meijinsen	Famicom
Famicom Shougi: Ryuu-Ou-Sen	Famicom
Famicom Top Management	Famicom
Famicom Wars	Famicom
Famicom Yakyuuban	Famicom
Family Block	Famicom
Family Boxing	Famicom
Family Circuit	Famicom
Family Circuit '91	Famicom
Family Computer Othello	Famicom
Family Jockey	Famicom
Family Mahjong	Famicom
Family Mahjong II: Shanghai he no Michi	Famicom
Family Pinball	Famicom
Family Quiz	Famicom
Family Tennis	Famicom
Family Trainer: Aerobics Studio	Famicom
Family Trainer: Athletic World	Famicom
Family Trainer: Daiundokai	Famicom
Family Trainer: Fuuun! Takeshi Shiro 2	Famicom
Family Trainer: Jogging Race	Famicom
Family Trainer: Manhattan Police	Famicom
Family Trainer: Meiro Daisakusen	Famicom
Family Trainer: Rai Rai! Kyonshizu:Baby Kyonshi no Amida Daibouken	Famicom
Family Trainer: Running Stadium	Famicom
Family Trainer: Tostugeki! Fuuun Takeshi Shiro	Famicom
Famista '89 Kaimaku Ban!!	Famicom
Famista '90	Famicom
Famista '91	Famicom
Famista '92	Famicom
Famista '93	Famicom
Famista '94	Famicom
Fantasy Zone	Famicom
Fantasy Zone 2: The Teardrop of Opa-Opa	Famicom
Faria Fuuin no Tsurugi	Famicom
Faxanadu	Famicom
FC Genjin	Famicom
Ferrari	Famicom
Field Combat	Famicom
Fighting Golf	Famicom
Fighting Road	Famicom
Final Fantasy	Famicom
Final Fantasy I+II	Famicom
Final Fantasy II	Famicom
Final Fantasy III	Famicom
Final Lap	Famicom
Final Mission	Famicom
Fire Emblem: Shadow Dragon and the Blade of Light	Famicom
Fire Emblem Gaiden	Famicom
Flappy	Famicom
Fleet Commander	Famicom
Flintstones: The Rescue of Dino and Hoppy	Famicom
Flipull	Famicom
Flying Hero	Famicom
Formation Z	Famicom
Front Line	Famicom
Fudou Myououden	Famicom
Fushigi na Blobby	Famicom
Fushigi no Umi no Nadia	Famicom
Fuzzical Fighter	Famicom
Galaga	Famicom
Galaxian	Famicom
Gambler Jiko Chuushinha	Famicom
Gambler Jiko Chuushinha 2	Famicom
Game Party	Famicom
Ganbare Goemon! Karakuri Dochu	Famicom
Ganbare Goemon 2	Famicom
Ganbare Goemon Gaiden: Kieta Ougon Kiseru	Famicom
Ganbare Goemon Gaiden 2	Famicom
Ganbare Pennant Race!	Famicom
Ganso Saiyuki: Super Monkey Daiboken	Famicom
Gegege no Kitaro: Youkai Daimakyou	Famicom
Gegege no Kitaro 2	Famicom
Geimos	Famicom
Gekikame Ninja Den	Famicom
Gekitotsu Shiku Battle	Famicom
Gekitou Pro Wrestling!! Toukon Densetsu	Famicom
Gekitou!! Stadium	Famicom
Genpei Toma Den	Famicom
Getsu Fuma Den	Famicom
Ghostbusters	Famicom
Gimme a Break: Shijou Saikyou no Quiz Ou Ketteisen	Famicom
Gimme a Break: Shijou Saikyou no Quiz Ou Ketteisen 2	Famicom
Gimmick!	Famicom
Ginga Eiyuu Densetsu	Famicom
Ginga no Sannin	Famicom
Goal !!	Famicom
God Slayer: Haruka Tenku no Sonata	Famicom
Gojira	Famicom
Golf	Famicom
The Golf '92	Famicom
Golf Club: Birdie Rush	Famicom
Golf Grand Slam	Famicom
Golf-kko Open	Famicom
Golgo 13: Kamigami no Koukon	Famicom
Golgo 13 II	Famicom
Gomoku Narabe Renju	Famicom
Goonies	Famicom
Goonies II: Fratelli Saigo no Chousen	Famicom
Gorby no Pipeline Daisakusen	Famicom
Gorilla Man	Famicom
Gozonji Yajikitatin Douchuu	Famicom
Gradius	Famicom
Gradius II	Famicom
Grand Master (Famicom)	Famicom
Great Battle Cyber	Famicom
Great Boxing - Rush Up	Famicom
Great Deal	Famicom
Great Tank	Famicom
Gremlins 2: The New Batch	Famicom
Guardic Gaiden	Famicom
Guevara	Famicom
GunHed: Aratanaru Tatakai	Famicom
Gun-Nac	Famicom
Gun Sight	Famicom
Gun-Dec	Famicom
Gyrodine	Famicom
Haja No Fuuin: Miracle Warriors	Famicom
Hana no Star Kaidou	Famicom
Hanjuku Hero	Famicom
Happy Birthday Bugs	Famicom
Hatris	Famicom
Hayauchi Super Igo	Famicom
Heavy Barrel	Famicom
Hebereke	Famicom
Hector '87	Famicom
Heisei Tensai Bakabon	Famicom
Hello Kitty no Hanabatake	Famicom
Hello Kitty World	Famicom
Heracles no Eikou: Toujin Makyouden	Famicom
Heracles no Eikou II: Titan no Metsubou	Famicom
Hi no Tori Hououhen: Gaou no Bouken	Famicom
Higemaru Makaijima - Nanatsu no Shima Daiboken	Famicom
Highway Star	Famicom
Hirake! Ponkikki	Famicom
Hiryu no Ken	Famicom
Hiryu no Ken II	Famicom
Hiryu no Ken III: 5 Nin no Ryuu Senshi	Famicom
Hiryu no Ken Special: Fighting Wars	Famicom
Hissatsu Doujou Yaburi	Famicom
Hissatsu Shigotojin	Famicom
Hitler no Fukkatsu: Top Secret	Famicom
Hogan's Alley	Famicom
Hokkaidou Rensa Satsujin: Ohotsuku ni Kiyu	Famicom
Hokuto no Ken	Famicom
Hokuto no Ken 2	Famicom
Hokuto no Ken 3	Famicom
Hokuto no Ken 4	Famicom
Holy Diver	Famicom
Home Run Night	Famicom
Home Run Night '90	Famicom
Honmei	Famicom
Honoo no Doukyuuji: Dodge Danpei	Famicom
Honoo no Doukyuuji: Dodge Danpei 2	Famicom
Honshougi: Naitou Kudan Shougi Hiden	Famicom
Hook	Famicom
Hoshi no Kirby: Yume no Izumi no Monogatari	Famicom
Hoshi wo Miru Hito	Famicom
Hostages	Famicom
Hototogisu	Famicom
Hottaman no Chitei Tanken	Famicom
Houma ga Koku	Famicom
Hudson Hawk	Famicom
Hyakkiyakou	Famicom
Hyaku no Sekai no Monogatari	Famicom
Hydlide Special	Famicom
Hydlide 3	Famicom
Hyokkori Hyoutan Shima: Nazo no Kaizokusen	Famicom
Hyper Olympic	Famicom
Hyper Sports	Famicom
I Love Softball	Famicom
Ice Climber	Famicom
Ide Yosuke Meijin no Jissen Mahjong	Famicom
Ide Yosuke Meijin no Jissen Mahjong II	Famicom
Idol Hakkenden	Famicom
Igo Meikan	Famicom
Igo Shinan	Famicom
Igo Shinan '91	Famicom
Igo Shinan '92	Famicom
Igo Shinan '93	Famicom
Igo Shinan '94	Famicom
Igo: Kyu Roban Taikyoku	Famicom
Ikari	Famicom
Ikari II	Famicom
Ikari III	Famicom
IkeIke! Nekketsu Hockey-bu	Famicom
Ikinari Musician	Famicom
Ikki	Famicom
Image Fight	Famicom
Inbou no Wakusei: Shankara	Famicom
Indora no Hikari	Famicom
Insector X	Famicom
Ishin no Arashi	Famicom
Itadaki Street: Watashi no Oten Niyottete	Famicom
Izaki Shuugorou no Keiba Hisshougaku	Famicom
J-League Fighting Soccer: The King of Ace Strikers	Famicom
Datach: J. League Super Top Players	Famicom
J-League Winning Goal	Famicom
Jackie Chan	Famicom
Jajamaru Gekimaden	Famicom
Jajamaru Ninpou Chou	Famicom
JaJaMaru no Daibouken	Famicom
Jangou	Famicom
Jarin-Ko Chie	Famicom
Jesus: Kyofu no Bio Monster	Famicom
The Jetsons: Cogswell's Caper!	Famicom
Jigoku Gokuraku Maru	Famicom
Jikuu (Toki) no Tabibito	Famicom
Jikuu Yuten Debias	Famicom
Jongbou	Famicom
Joust	Famicom
Joy Mech Fight	Famicom
JuJu Densetsu	Famicom
Jumbo Ozaki no Hole in One Professional	Famicom
Jumpin' Kid: Jack to Mame no Ki Monogatari	Famicom
Just Breed	Famicom
Juuryoku Soukou Metal Storm	Famicom
Juvei Quest	Famicom
Jyuouki	Famicom
Kabushiki Doujou	Famicom
Kage	Famicom
Kage no Densetsu	Famicom
Kagerou Densetsu	Famicom
Kaguya Hime Densetsu	Famicom
Kai no Bouken: The Quest of Ki	Famicom
Kaijuu Monogatari	Famicom
Kaiketsu Yancha Maru	Famicom
Kaiketsu Yancha Maru 2: Karakuri Land	Famicom
Kaiketsu Yanchamaru 3: Taiketsu! Zouringen	Famicom
Kakefu Kimi no Jump Tengoku	Famicom
Kame no Ongaeshi	Famicom
Kamen no Ninja Akakage	Famicom
Kamen no Ninja Hamaru	Famicom
Kamen Rider Club	Famicom
Kamen Rider SD	Famicom
Karakuri Kengoden Musashi Lord: Karakuri Jin Shissouru	Famicom
Karaoke Studio	Famicom
Karaoke Studio Senyou Cassette Vol. 1	Famicom
Karaoke Studio Senyou Cassette Vol. 2	Famicom
Karateka	Famicom
Karnov	Famicom
Katte ni Shirokuma	Famicom
Kawa no Nushi Tsuri	Famicom
Kekkyoku Nankyoku Daibouken	Famicom
Kero Kero Keroppi no Daibouken	Famicom
Kero Kero Keroppi no Daibouken 2	Famicom
Keroppi to Keroriinu no Splash Bomb	Famicom
Kido Senshi Z-Gundam: Hot Scramble	Famicom
King Kong 2: Ikari no Megaton Punch	Famicom
King of Kings	Famicom
King's Knight	Famicom
Kinnikuman: Muscle Tag Match	Famicom
Kiteretsu Daihyakka	Famicom
Kitte Rai Da! Gunjin Shougi Nanya Sore?	Famicom
Klax	Famicom
Knight Rider	Famicom
Konami Sports in Seoul	Famicom
Koufuku o Yobu Game: Dora Dora Dora	Famicom
Koryu Densetsu Villgust Gaiden	Famicom
Koshien	Famicom
Kujaku Ou	Famicom
Kujaku Ou II	Famicom
Kunio-Kun no Jidaigeki dayo Zenin Shuugou: Downtown Special	Famicom
Kunio-Kun no Nekketsu Soccer League	Famicom
Kurogane Hiroshi no Yosou Daisuki! Kachiuma Densetsu	Famicom
Kyatto Ninden Teyandee	Famicom
Kyonshis 2	Famicom
Kyorochan Land	Famicom
Kyoryu Sentai Zyuranger	Famicom
Kyouto Hana no Misshitsu Satsujin Jiken - Yamamura Misa Suspense	Famicom
Kyouto Ryuu no Tera Satsujin Jiken - Yamamura Misa Suspense	Famicom
Kyouto Zaiteku Satsujin Jiken Yamamura Misa Suspense	Famicom
Kyuukyoku Harikiri Koshien	Famicom
Kyuukyoku Harikiri Stadium	Famicom
Kyuukyoku Harikiri Stadium '88	Famicom
Kyuukyoku Harikiri Stadium Heisei Gannenhan	Famicom
Kyuukyoku Harikiri Stadium III	Famicom
Kyuukyoku Tiger	Famicom
L'Empereur	Famicom
Labyrinth	Famicom
Lagrange Point	Famicom
Last Armageddon	Famicom
Law of the West	Famicom
Layla	Famicom
Little Magic	Famicom
Little Mermaid	Famicom
Lode Runner	Famicom
Lord of King	Famicom
Lost Word of Jenny	Famicom
Lot Lot	Famicom
Lunar Ball	Famicom
Lupin III Sansei: Pandora No Isan	Famicom
Meitantei Holmes: M-Kara no Chousenjou	Famicom
Mach Rider	Famicom
Mad City	Famicom
Magic Candle	Famicom
Magic Darts	Famicom
Magic John	Famicom
Magical Taruruto-Kun: Fantastic World!!	Famicom
Magical Taruruto-Kun 2: Magical Adventure	Famicom
Magical Kids Doropi	Famicom
MagMax	Famicom
Magnum Kiki Ippatsu: Empire City 1931	Famicom
MahaRaja	Famicom
Mahjong	Famicom
Mahjong Club Nagatacho: Sousaisen	Famicom
Mahjong Taikai	Famicom
Mahjong Taisen	Famicom
Mahou no Princess Minkiimomo Remember Dream	Famicom
Maison Ikkoku	Famicom
Majaventure - Mahjong Senki	Famicom
Mashin Eiyuden Wataru Gaiden	Famicom
Majou Densetsu II: The Maze of Galious	Famicom
Major League	Famicom
Makai-Mura	Famicom
Maniac Mansion	Famicom
Mappy	Famicom
Mappy Kids	Famicom
Mappy-Land	Famicom
Mario Bros.	Famicom
Mario Open Golf	Famicom
Marusa no Onna	Famicom
Mashou	Famicom
Masuzoe Kaname Icchou Made Famicom	Famicom
Matendo Douji	Famicom
Matsumoto Akira no Kabushiki Hisshougaku	Famicom
Matsumoto Akira no Kabushiki Hisshougaku II	Famicom
Max Warrior	Famicom
Meiji Ishin	Famicom
Meikyuu Kumikyoku	Famicom
Meikyuu Shima	Famicom
Meimon! Daisan Yakyuubu	Famicom
Meimon! Tako Nishiouendan	Famicom
Meitantei Holmes: Kiri no London Satsujin Jiken	Famicom
Melville no Honoo	Famicom
Metal Flame: Psybuster	Famicom
Metal Gear	Famicom
Metal Max	Famicom
Metal Slader Glory	Famicom
Metro Cross	Famicom
Mezase! Top Pro: Green ni Kakeru Yume	Famicom
Mickey Mouse	Famicom
Mickey Mouse III: Yume Fuusen	Famicom
Might and Magic Book One: The Secret of the Inner Sanctum	Famicom
Mighty Bomb Jack	Famicom
Mighty Final Fight	Famicom
Millipede	Famicom
Mindseeker	Famicom
Minelvaton Saga: Ragon no Fukkatsu	Famicom
Mini-Putt	Famicom
Minna no Tabou no Nakayoshi Daisakusen	Famicom
Miracle Ropitt: 2100-Nen no Daiboken	Famicom
Mirai Senshi Raios	Famicom
Mirai Shinwa Jarvas	Famicom
Mississippi Satsujin Jiken	Famicom
Mitokoumon	Famicom
Mitokoumon II: Sekai Manyuuki	Famicom
Mitsume ga Tooru	Famicom
Mizushima Shinji no Daikoushien	Famicom
Moai-Kun	Famicom
Moe-Pro! Saikyou Hen	Famicom
Moero TwinBee	Famicom
Moero!! Judo Warriors	Famicom
Moero!! Junior Basket	Famicom
Moero!! Pro Soccer	Famicom
Moero!! Pro Tennis	Famicom
Moero!! Pro Yakyuu	Famicom
Moero!! Pro Yakyuu '88	Famicom
Moero!! Pro Yakyuu '90: Kandouhen	Famicom
Moeru! Oniisan	Famicom
Mokushi Pachi Pro: Pachi Otto-Kun	Famicom
Momotaro Densetsu	Famicom
Momotarou Densetsu Gaiden	Famicom
Momotaro Dentetsu	Famicom
Money Game	Famicom
Money Game II: Kabutochou no Kiseki	Famicom
Monopoly	Famicom
Monster Maker: Nanatsu no Hiho	Famicom
Moon Crystal	Famicom
Morita Shougi	Famicom
Mother	Famicom
Motocross Champion	Famicom
Mottomo Abunai Deka	Famicom
Mouryou Senki Madara	Famicom
Murder Club	Famicom
Musashi no Boken	Famicom
Musashi no Ken – Tadaima Shugyo Chu	Famicom
My Life My Love: Boku no Yume: Watashi no Negai	Famicom
Nagagutsu o Haita Neko: Sekai Isshu 80 Nichi Dai Boken	Famicom
Nakajima Satoru: F-1 Hero	Famicom
Nakajima Satoru F-1 Hero 2	Famicom
Nakayo Shito Issho	Famicom
Namco Classic	Famicom
Namco Classic II	Famicom
Namco Mahjong III: Mahjong Tengoku	Famicom
Nantettatte!! Baseball	Famicom
Nantettatte Baseball KO Game Cassette '91 Kaimakuban	Famicom
Nantettatte Baseball KO Game Set OB All Star Hen	Famicom
Napoleon Senki	Famicom
Navy Blue	Famicom
Nekketsu Kakutou Densetsu	Famicom
Nekketsu Kouha Kunio Kun	Famicom
Nekketsu Koukou Dodge Ball Bu	Famicom
Nekketsu Koukou Dodgeball-bu Soccer-hen	Famicom
Nekketsu Street Basket: Ganbare Dunk Heroes	Famicom
New Ghostbusters 2	Famicom
New York Nyankies	Famicom
Nichibutsu Mahjong III	Famicom
Niji no Silkroad	Famicom
Ningen Heiki Dead Fox	Famicom
Ninja Cop Saizou	Famicom
Ninja Crusaders	Famicom
Ninja Hattori-kun	Famicom
Ninja JaJaMaru-kun	Famicom
Ninja Jajamaru: Ginga Daisakusen	Famicom
Ninja Kun	Famicom
Ninja Kun: Ashura no Shou	Famicom
Ninja Ra Hoi!	Famicom
Ninja Ryuukenden	Famicom
Ninja Ryuukenden II	Famicom
Ninja Ryuukenden III	Famicom
Nippon Ichi no Nakantoku	Famicom
Nishimura Kyoutarou Mystery: Blue Train Satsujin Jiken	Famicom
Nishimura Kyoutarou Mystery: Super Express Satsujin Jiken	Famicom
Nobunaga no Yabou: Bushou Fuuunroku	Famicom
Nobunaga no Yabou: Sengouku Gunyuuden	Famicom
Nobunaga no Yabou: Zenkokuban	Famicom
North and South	Famicom
Nuts & Milk	Famicom
Obake no Q Tarou: Wan Wan Panic	Famicom
Obocchamakun	Famicom
Ochinnitoshi Puzzle Tonjan!?	Famicom
Oeka Kids - Anpanman no Hiragana Daisuki	Famicom
Oeka Kids - Anpanman to Oekaki Shiyou	Famicom
Oishinbo: Kyukyoku no Menu 3bon Syoubu	Famicom
Olympus no Tatakai	Famicom
Onyanko Town	Famicom
Operation Wolf	Famicom
Osomatsu-Kun: Back to Zami no Deppa	Famicom
Otaku no Seiza	Famicom
Outlanders	Famicom
Over Horizon	Famicom
Paaman	Famicom
Paaman Part 2	Famicom
Pac-Land	Famicom
Pac-Man	Famicom
Pachicom	Famicom
Pachi-Slot Adventure 2	Famicom
Pachi-Slot Adventure 3: Bitaoshii 7 Kenzan!	Famicom
Pachinko Daisakusen	Famicom
Pachinko Daisakusen 2	Famicom
Pachiokun 2	Famicom
Pachiokun 3	Famicom
Pachiokun 4	Famicom
Pachiokun 5	Famicom
Palamedes	Famicom
Palamedes 2	Famicom
Paperboy	Famicom
Parareru World	Famicom
Parasol Henbee	Famicom
Paris-Dakar Rally Special	Famicom
Parodius Da! -Shinwa kara Owarai e-	Famicom
Peepar Time	Famicom
Penguin-Kun Wars	Famicom
Perfect Bowling	Famicom
Photon: The Ultimate Game on Planet Earth	Famicom
Pinball	Famicom
Pinball Quest	Famicom
Pizza Pop	Famicom
Plasma Ball	Famicom
Pocket Zaurus: Ju Ouken no Nazo	Famicom
Pooyan	Famicom
Popeye	Famicom
Popeye no Eigo Asobi	Famicom
Portopia Renzoku Satsujin Jiken	Famicom
Power Blazer	Famicom
Power Soccer	Famicom
Predator	Famicom
President no Sentaku	Famicom
Pro Yakyuu Family Stadium	Famicom
Pro Yakyuu Family Stadium '87	Famicom
Pro Yakyuu Family Stadium '88	Famicom
Pro Yakyuu Satsujin Jiken!	Famicom
Punch-Out!!	Famicom
Puyo Puyo	Famicom
Puzzlot	Famicom
Puzznic	Famicom
Pajama Hero Nemo	Famicom
Pyokotan no Daimeiro	Famicom
Quarterback Scramble	Famicom
Quarth	Famicom
Quinty	Famicom
Quiz Project Q: Cutie Project & Battle 1000	Famicom
Racer Mini Yonku: Japan Cup	Famicom
Radia Senki: Reimeihen	Famicom
Raf World	Famicom
Raid on Bungeling Bay	Famicom
Rainbow Island: The Story of Bubble Bobble 2	Famicom
Rambo	Famicom
Rampart	Famicom
Rasaru Ishii no Childs Quest	Famicom
Recca - Summer Carnival '92	Famicom
Red Arremer II	Famicom
Reigen Doushi	Famicom
Rekka no Gotoku Tenka o Tore!	Famicom
Ripple Island	Famicom
Road Fighter	Famicom
Robocco Wars	Famicom
RoboCop	Famicom
RoboCop 2	Famicom
Robot Block	Famicom
Robot Gyro	Famicom
Rockman	Famicom
Rockman 2: Dr. Wily no Nazo	Famicom
Rockman 3: Dr. Wily no Saigo!?	Famicom
Rockman 4: Aratanaru Yabo!!	Famicom
Rockman 5: Blues no Wana!?	Famicom
Rockman 6: Shijo Saidai no Tatakai!!	Famicom
Rokudenashi Blues	Famicom
Rollerball	Famicom
Rolling Thunder	Famicom
Route 16 Turbo	Famicom
Royal Blood	Famicom
RPG Jinsei Game	Famicom
Sensha Senryaku: Sabaku no Kitsune	Famicom
Saikoushi Sedi	Famicom
Saint Seiya	Famicom
Saint Seiya 2	Famicom
Saiyuuki World	Famicom
Saiyuuki World 2	Famicom
Sakigake!! Otokojuku	Famicom
Salad no Kuni no Tomato Hime	Famicom
Salamander	Famicom
San Goku Shi	Famicom
San Goku Shi II	Famicom
San Goku Shi: Chuugen no Hasha	Famicom
San Goku Shi II: Haou no Tairiku	Famicom
Sanada Juu Yuushi	Famicom
Sanma no Meitantei	Famicom
Sanrio Carnival	Famicom
Sanrio Carnival 2	Famicom
Sanrio Cup: Pon Pon Volley	Famicom
Sansara Naga	Famicom
Sansu 1-nen: Keisan Game	Famicom
Sansu 2-nen: Keisan Game	Famicom
Sansu 3-nen: Keisan Game	Famicom
Sansu 4-nen: Keisan Game	Famicom
Sansu 5+6-nen: Keisan Game	Famicom
Satomi Hakkenden	Famicom
Satsui no Kaisou	Famicom
SD Battle Oozumou	Famicom
SD Gundam Gachapon Senshi 2: Capsule Senki	Famicom
SD Gundam Gachapon Senshi 3: Eiyuu Senki	Famicom
SD Gundam Gachapon Senshi 4: New Type Story	Famicom
SD Gundam Gachapon Senshi 5: Battle of Universal Century	Famicom
SD Gundam Gaiden: Knight Gundam Monogatari	Famicom
SD Gundam Gaiden: Knight Gundam Monogatari 2: Hikari no Kishi	Famicom
SD Gundam Gaiden: Knight Gundam Monogatari 3	Famicom
Datach: SD Gundam: Gundam Wars	Famicom
SD Hero Soukessen: Taose! Aku no Gundan	Famicom
SD Keiji Blader	Famicom
Seicross	Famicom
Seikima II Akuma no Gyakushu!	Famicom
Seirei Densetsu Lickle	Famicom
Seirei Gari	Famicom
Sekiryuou	Famicom
Senjo no Ookami	Famicom
Shadow Brain	Famicom
Shadowgate	Famicom
Shanghai	Famicom
Shanghai II	Famicom
Sherlock Holmes: Hakushaku Reijo Yukai Jiken	Famicom
Shikinjo	Famicom
Shin 4-Jin Uchi Mahjong: Yakuman Tengoku	Famicom
Shin Moero!! Pro Yakyuu	Famicom
Shin Satomi Hakken-Den - Hikari to Yami no Tatakai	Famicom
Shinjinrui	Famicom
Shinsenden	Famicom
Shougi Meikan '92	Famicom
Shougi Meikan '93	Famicom
Shogun	Famicom
Shonen Ashibe Nepal Daibouken no Maki	Famicom
Shuffle Fight	Famicom
Shufflepuck Cafe	Famicom
Side Pocket	Famicom
Silva Saga	Famicom
Sky Destroyer	Famicom
Sky Kid	Famicom
Snow Bros.	Famicom
Soccer	Famicom
Softball Tengoku	Famicom
Solomon no Kagi	Famicom
Solomon no Kagi 2	Famicom
Solstice	Famicom
SonSon	Famicom
Soreike! Anapanman Minna de Hiking Game	Famicom
Space Harrier	Famicom
Space Hunter	Famicom
Space Invaders	Famicom
Space Shadow	Famicom
Spartan X	Famicom
Spartan X 2	Famicom
Spelunker	Famicom
Spelunker II: Yusha e no Chosen	Famicom
Splatterhouse: Wanpaku Graffiti	Famicom
Spot	Famicom
Spy vs. Spy	Famicom
Spy Vs. Spy II: Nankoku Shirei!!	Famicom
Sqoon	Famicom
Square no Tom Sawyer	Famicom
Star Force	Famicom
Star Luster	Famicom
Star Soldier	Famicom
Star Wars	Famicom
Star Wars	Famicom
Star Wars: Teikoku no Gyakushuu	Famicom
Stargate	Famicom
STED: Iseki Wakusei no Yabou	Famicom
Stick Hunter	Famicom
Sugoro Quest: Dice no Senshi Tachi	Famicom
Suikoden: Tenmei no Chikai	Famicom
Sukeban Deka III	Famicom
Super Arabian	Famicom
Super Black Onyx	Famicom
Super Chinese	Famicom
Super Chinese 2	Famicom
Super Chinese 3	Famicom
Super Contra	Famicom
Super Dynamix Badminton	Famicom
Super Mario Bros.	Famicom
Super Mario Bros. 3	Famicom
Super Mario USA	Famicom
Super Mogura Tataki!! Pokkun Mogura	Famicom
Super Momotaro Dentetsu	Famicom
Super Pinball	Famicom
Super Pitfall	Famicom
Super Real Baseball '88	Famicom
Super Rugby	Famicom
Super Sprint	Famicom
Super Star Force: Jikureki no Himitsu	Famicom
Super Star Pro Wrestling	Famicom
Super Xevious: GAMP no Nazo	Famicom
Superman	Famicom
SWAT: Special Weapons and Tactics	Famicom
Sweet Home	Famicom
Sword Master	Famicom
Tag Team Pro Wrestling	Famicom
Taito Basketball	Famicom
Taito Chase H.Q.	Famicom
Taito Grand Prix: Eikou heno License	Famicom
Taiyou no Shinden Asteka II	Famicom
Taiyou no Yuusha Firebird	Famicom
Takahashi Meijin no Boken Jima	Famicom
Takahashi Meijin no Boken Jima II	Famicom
Takahashi Meijin no Boken Jima III	Famicom
Takahashi Meijin no Boken Jima IV	Famicom
Takahashi Meijin no Bug-tte Honey	Famicom
Takeda Shingen	Famicom
Takeda Shingen II	Famicom
Takeshi no Chosenjo	Famicom
Takeshi no Sengoku Fuunji	Famicom
Tamura Teruaki no Mahjong Seminar	Famicom
Tanikawa Koji no Shougi Shinan II	Famicom
Tanikawa Koji no Shougi Shinan III	Famicom
Tantei Jinguji Saburo: Yokohamakou Renzoku Satsujin Jiken	Famicom
Tantei Jinguji Saburo: Toki no Sugiyuku Mama Ni	Famicom
Tao	Famicom
Tashiro Masashi no Princess ga Ippai	Famicom
Tatakae! Cho Robot Seimeitai Transformers: Convoy no Nazo	Famicom
Tatakai no Banka	Famicom
Tatake!! Ramen-Man	Famicom
Tecmo Bowl	Famicom
Tecmo Super Bowl	Famicom
Tecmo World Cup Soccer	Famicom
Teenage Mutant Ninja Turtles: Super Kame Ninja	Famicom
Teenage Mutant Ninja Turtles II: The Manhattan Project	Famicom
Tenchi o Kurau	Famicom
Tenchi o Kurau II	Famicom
Tenkaichi Bushi Keru Naguuru	Famicom
Tennis	Famicom
Terao no Dosukoi Oozumou	Famicom
Terminator 2	Famicom
Terra Cresta	Famicom
Tetra Star	Famicom
Tetris	Famicom
Tetris 2 + Bombliss	Famicom
Tetris Flash	Famicom
Tetsudou-Oh	Famicom
Tetsuwan Atom	Famicom
Thexder	Famicom
Thunderbirds	Famicom
Tiger-Heli	Famicom
Time Zone	Famicom
Times of Lore	Famicom
Tiny Toon Adventures	Famicom
Tiny Toon Adventures 2: Montana Land e Yokoso	Famicom
Titan	Famicom
TM Network: Live in Power Bowl	Famicom
Tobidase Daisakusen 2: JJ	Famicom
Tokkyu Shirei Solbrain	Famicom
Tokoro-san no Mamoru mo Semeru mo	Famicom
Tokyo Pachi-Slot Adventure	Famicom
Tom & Jerry	Famicom
Tom Sawyer no Bouken	Famicom
Top Gun	Famicom
Top Gun: Dual Fighters	Famicom
Top Rider	Famicom
Top Striker	Famicom
Totsuzen! Macho Man	Famicom
Touch Down Fever: American Football	Famicom
Touhou Kenbunku	Famicom
Tokaido Gojusan-tsugi	Famicom
Toukon Club	Famicom
The Tower of Druaga	Famicom
The Triathlon	Famicom
Tsuppari Oozumou	Famicom
Tsuppari Wars	Famicom
Tsurikichi Sanpei	Famicom
Tsuru Pikahage Maru: Mezase! Tsuruseko no Akashi	Famicom
Twin Eagle: Revenge Joe's Brother	Famicom
TwinBee	Famicom
TwinBee 3	Famicom
Uchuu Keibitai SDF	Famicom
Uchusen: Cosmo Carrier	Famicom
Ultima	Famicom
Ultima: Seisha he no Michi	Famicom
Ultraman Club Kaijuu Dai Kessen!!	Famicom
Datach: Ultraman Club: Supokon Fight!	Famicom
Ultraman Club 2: Kaettekita Ultraman Club	Famicom
Ultraman Club 3	Famicom
The Untouchables	Famicom
Urban Champion	Famicom
Urusei Yatsura: Lum's Wedding Bell	Famicom
US Championship V'Ball	Famicom
USA Ice Hockey in FC	Famicom
Ushio to Tora: Shin'en no Daiyo	Famicom
Utsurun Desu.: Kawauso Hawaii e Iku!!!	Famicom
Valkyrie no Boken: Toki no Kagi Densetsu	Famicom
Valis: The Fantasm Soldier	Famicom
Vegas Connection: Casino Kara Ai wo Komete	Famicom
Venus Senki	Famicom
Viva Las Vegas	Famicom
Volguard II	Famicom
Wagyan Land	Famicom
Wagyan Land 2	Famicom
Wagyan Land 3	Famicom
Wai Wai World	Famicom
Wai Wai World 2: SOS!! Parsley Jo	Famicom
Wanpaku Duck Yume Bouken	Famicom
Wanpaku Kokkun no Gourmet World	Famicom
Wario no Mori	Famicom
Warpman	Famicom
Western Kids	Famicom
White Lion Densetsu	Famicom
Wild Gunman	Famicom
Willow	Famicom
Wily & Right no RockBoard: That's Paradise	Famicom
Wing of Madoola	Famicom
Winners Cup	Famicom
Wit's	Famicom
Wizardry: Proving Grounds of the Mad Overlord	Famicom
Wizardry II: Legacy of Llylgamyn - The Third Scenario	Famicom
Wizardry III: Knight of Diamonds - The Second Scenario	Famicom
Woody Poko	Famicom
World Boxing	Famicom
World Grand-Prix - Pole To Finish	Famicom
World Super Tennis	Famicom
Wrecking Crew	Famicom
WWF WrestleMania Challenge	Famicom
Xevious	Famicom
Yie Ar Kung Fu	Famicom
Yoshi no Cookie	Famicom
Yoshi no Tamago	Famicom
Yokai Dochuki	Famicom
Youkai Club	Famicom
Yousei Monogatari RodLand	Famicom
Ys	Famicom
Ys II	Famicom
Ys III: Wanderers from Ys	Famicom
Yume Penguin Monogatari	Famicom
Datach: YuYu Hakusho: Bakuto Ankoku Bujutsu Kai	Famicom
Zelda no Densetsu 1	Famicom
Zenbei!! Pro Basketball	Famicom
Zippy Race	Famicom
Zoids: Chuuou Tairiku no Tatakai	Famicom
Zoids 2: Zenebasu no Gyakushuu	Famicom
Zoids: Mokushiroku	Famicom
Zombie Hunter	Famicom
Zuno Senkan Galg	Famicom